2008_000200 1
2008_000200 2
2008_000210 1
2008_000216 1
2008_000216 2
2008_000216 4
2008_000216 5
2008_000228 1
2008_000263 1
2008_000263 2
2008_000280 1
2008_000280 2
2008_000280 3
2008_000280 4
2008_000303 1
2008_000303 3
2008_000303 4
2008_000317 2
2008_000325 1
2008_000331 1
2008_000333 1
2008_000352 1
2008_000355 1
2008_000355 2
2008_000389 1
2008_000402 1
2008_000438 1
2008_000438 2
2008_000449 1
2008_000451 1
2008_000451 2
2008_000451 3
2008_000509 1
2008_000509 2
2008_000509 3
2008_000528 2
2008_000574 1
2008_000574 2
2008_000610 1
2008_000611 1
2008_000611 2
2008_000616 1
2008_000618 1
2008_000618 2
2008_000624 1
2008_000637 2
2008_000639 2
2008_000639 3
2008_000639 4
2008_000639 5
2008_000639 6
2008_000642 1
2008_000642 2
2008_000701 2
2008_000715 1
2008_000715 2
2008_000720 1
2008_000728 1
2008_000730 1
2008_000730 2
2008_000735 1
2008_000735 2
2008_000820 1
2008_000820 2
2008_000820 3
2008_000820 4
2008_000822 1
2008_000822 2
2008_000826 1
2008_000826 2
2008_000925 1
2008_000927 1
2008_000946 3
2008_000983 1
2008_000983 2
2008_001003 1
2008_001006 1
2008_001006 2
2008_001006 3
2008_001033 1
2008_001033 2
2008_001094 1
2008_001095 1
2008_001095 2
2008_001214 1
2008_001237 1
2008_001273 3
2008_001289 1
2008_001289 2
2008_001293 1
2008_001293 2
2008_001381 1
2008_001381 2
2008_001397 2
2008_001397 3
2008_001487 1
2008_001509 1
2008_001509 2
2008_001524 1
2008_001524 2
2008_001524 3
2008_001561 1
2008_001606 1
2008_001606 2
2008_001606 3
2008_001634 1
2008_001634 2
2008_001634 3
2008_001646 3
2008_001646 4
2008_001657 1
2008_001671 2
2008_001696 1
2008_001696 2
2008_001718 1
2008_001726 1
2008_001726 2
2008_001748 1
2008_001754 1
2008_001754 2
2008_001767 1
2008_001767 2
2008_001778 1
2008_001840 1
2008_001847 1
2008_001847 2
2008_001847 3
2008_001847 4
2008_001901 1
2008_001901 3
2008_001901 4
2008_001942 1
2008_001976 1
2008_001984 1
2008_001995 1
2008_001995 2
2008_001995 3
2008_001996 1
2008_002006 1
2008_002008 1
2008_002053 1
2008_002053 2
2008_002078 1
2008_002078 2
2008_002078 3
2008_002078 4
2008_002078 5
2008_002078 6
2008_002097 2
2008_002097 3
2008_002097 4
2008_002183 1
2008_002224 1
2008_002260 1
2008_002260 2
2008_002260 5
2008_002274 2
2008_002274 3
2008_002274 4
2008_002277 1
2008_002319 1
2008_002346 1
2008_002346 2
2008_002351 2
2008_002355 1
2008_002503 1
2008_002520 1
2008_002529 1
2008_002529 2
2008_002537 1
2008_002538 1
2008_002557 1
2008_002561 1
2008_002596 1
2008_002627 1
2008_002627 2
2008_002633 1
2008_002637 1
2008_002637 2
2008_002651 1
2008_002658 1
2008_002658 2
2008_002664 2
2008_002729 1
2008_002771 1
2008_002803 1
2008_002827 1
2008_002851 1
2008_002851 2
2008_002851 4
2008_002853 1
2008_002855 1
2008_002858 1
2008_002858 2
2008_002867 1
2008_002896 1
2008_002896 2
2008_002896 3
2008_002896 4
2008_002918 1
2008_002918 2
2008_002924 1
2008_002924 2
2008_002949 2
2008_002969 1
2008_002978 1
2008_003002 1
2008_003002 2
2008_003007 1
2008_003007 2
2008_003012 1
2008_003027 1
2008_003044 1
2008_003080 1
2008_003096 1
2008_003126 1
2008_003185 1
2008_003190 1
2008_003257 1
2008_003279 1
2008_003284 1
2008_003332 1
2008_003332 2
2008_003365 1
2008_003370 1
2008_003419 2
2008_003438 1
2008_003438 2
2008_003446 1
2008_003459 1
2008_003460 1
2008_003460 2
2008_003505 1
2008_003601 1
2008_003603 1
2008_003603 2
2008_003616 1
2008_003616 2
2008_003632 2
2008_003632 3
2008_003632 4
2008_003643 1
2008_003643 2
2008_003695 1
2008_003695 2
2008_003696 1
2008_003696 2
2008_003696 3
2008_003696 6
2008_003736 1
2008_003736 2
2008_003736 3
2008_003747 1
2008_003747 2
2008_003758 1
2008_003758 2
2008_003765 1
2008_003836 1
2008_003855 1
2008_003861 1
2008_003861 2
2008_003861 3
2008_003880 1
2008_003907 1
2008_003907 2
2008_003907 3
2008_003910 1
2008_003960 1
2008_004011 1
2008_004011 2
2008_004011 3
2008_004029 1
2008_004029 2
2008_004065 1
2008_004065 2
2008_004095 1
2008_004136 3
2008_004136 6
2008_004136 9
2008_004136 10
2008_004206 1
2008_004210 1
2008_004210 2
2008_004226 1
2008_004238 1
2008_004241 1
2008_004241 2
2008_004340 1
2008_004341 1
2008_004370 1
2008_004370 2
2008_004379 1
2008_004392 1
2008_004413 1
2008_004437 1
2008_004437 2
2008_004437 3
2008_004440 1
2008_004456 1
2008_004496 1
2008_004511 1
2008_004517 3
2008_004521 1
2008_004523 1
2008_004569 1
2008_004604 1
2008_004657 1
2008_004954 1
2008_006015 1
2008_006727 1
2008_006971 1
2008_007387 1
2008_007982 1
2008_007982 2
2008_008054 1
2008_008251 2
2008_008742 1
