2007_000027 1
2007_000272 1
2007_000423 1
2007_000423 2
2007_000664 1
2007_000807 1
2007_001558 1
2007_001558 2
2007_001583 1
2007_001583 2
2007_001627 1
2007_001667 1
2007_001686 1
2007_002079 1
2007_002079 2
2007_002262 1
2007_002344 1
2007_003091 1
2007_003091 2
2007_003104 1
2007_003226 1
2007_003329 1
2007_003581 1
2007_003581 2
2007_003581 3
2007_003659 1
2007_003745 1
2007_003747 1
2007_003831 1
2007_003831 2
2007_004000 1
2007_004000 2
2007_004049 1
2007_004049 2
2007_004092 1
2007_004133 1
2007_004197 1
2007_004238 1
2007_004238 2
2007_004238 3
2007_004265 1
2007_004397 1
2007_004454 1
2007_004517 1
2007_004713 1
2007_004770 1
2007_004795 1
2007_004831 1
2007_005019 1
2007_005019 2
2007_005206 1
2007_005310 1
2007_005310 2
2007_005405 1
2007_005425 1
2007_005425 2
2007_005450 1
2007_005527 1
2007_005657 1
2007_005691 1
2007_005695 1
2007_005695 2
2007_005748 1
2007_005748 2
2007_005764 1
2007_005896 1
2007_005969 1
2007_005971 1
2007_005972 1
2007_006163 1
2007_006240 1
2007_006282 1
2007_006442 1
2007_006442 2
2007_006559 1
2007_006587 1
2007_006614 1
2007_006744 1
2007_006744 2
2007_006786 1
2007_006786 2
2007_006788 1
2007_006808 1
2007_006809 1
2007_006856 1
2007_006901 1
2007_006901 2
2007_006981 1
2007_007016 1
2007_007016 2
2007_007016 3
2007_007020 1
2007_007031 1
2007_007031 2
2007_007080 1
2007_007083 1
2007_007103 1
2007_007119 1
2007_007151 1
2007_007161 1
2007_007277 1
2007_007318 1
2007_007330 1
2007_007336 1
2007_007336 2
2007_007420 1
2007_007438 1
2007_007531 1
2007_007531 2
2007_007531 3
2007_007582 1
2007_007595 1
2007_007606 1
2007_007618 1
2007_007763 1
2007_007763 2
2007_007763 3
2007_007763 4
2007_007763 5
2007_007763 6
2007_007763 7
2007_007769 1
2007_007769 2
2007_007871 1
2007_007871 2
2007_007871 3
2007_007877 1
2007_007877 2
2007_007892 1
2007_007910 1
2007_007917 1
2007_007917 2
2007_007917 3
2007_007940 1
2007_007955 1
2007_008013 1
2007_008157 1
2007_008157 2
2007_008157 3
2007_008211 1
2007_008321 1
2007_008396 1
2007_008396 2
2007_008446 1
2007_008446 2
2007_008559 1
2007_008559 2
2007_008567 1
2007_008647 1
2007_008664 1
2007_008690 1
2007_008816 1
2007_008921 1
2007_009040 1
2007_009153 1
2007_009253 1
2007_009253 2
2007_009391 1
2007_009402 1
2007_009425 1
2007_009578 1
2007_009579 1
2007_009610 1
2007_009612 1
2007_009653 1
2007_009653 2
2007_009653 3
2007_009736 1
2007_009738 1
2007_009783 1
2007_009910 1
2007_009910 2
2008_000733 1
2008_000778 1
2008_001215 1
2008_001408 1
2008_001501 1
2008_001501 2
2008_001501 3
2008_001501 4
2008_001501 5
2008_001501 6
2008_001501 7
2008_001501 9
2008_002145 1
2008_002247 1
2008_002251 1
2008_002251 2
2008_002251 3
2008_002262 1
2008_002856 1
2008_003122 1
2008_003342 1
2008_003342 4
2008_003773 1
2008_003871 1
2008_003891 1
2008_003891 2
2008_003891 3
2008_004567 1
2008_008122 2
2008_008122 3
