2008_000223 1
2008_000407 1
2008_000407 2
2008_000475 2
2008_000475 3
2008_000510 1
2008_000535 2
2008_000535 3
2008_000558 1
2008_000568 1
2008_000569 1
2008_000630 1
2008_000634 1
2008_000662 1
2008_000700 1
2008_000737 1
2008_000740 1
2008_000745 1
2008_000780 1
2008_000780 2
2008_000825 1
2008_000878 1
2008_000992 1
2008_001028 1
2008_001063 2
2008_001063 4
2008_001063 5
2008_001066 1
2008_001066 2
2008_001066 3
2008_001066 4
2008_001074 1
2008_001076 1
2008_001090 2
2008_001255 1
2008_001306 1
2008_001353 1
2008_001429 1
2008_001470 1
2008_001470 2
2008_001491 1
2008_001504 1
2008_001534 1
2008_001540 1
2008_001540 2
2008_001540 3
2008_001547 1
2008_001551 1
2008_001551 2
2008_001551 4
2008_001553 2
2008_001598 1
2008_001602 1
2008_001607 1
2008_001607 2
2008_001619 1
2008_001619 2
2008_001668 1
2008_001668 2
2008_001712 1
2008_001731 1
2008_001731 2
2008_001745 1
2008_001745 2
2008_001745 3
2008_001745 4
2008_001763 1
2008_001763 2
2008_001782 3
2008_001802 2
2008_001812 1
2008_001874 1
2008_001907 1
2008_001909 1
2008_001909 2
2008_001919 1
2008_001919 2
2008_002017 1
2008_002017 2
2008_002035 1
2008_002039 1
2008_002039 2
2008_002052 1
2008_002099 2
2008_002099 3
2008_002132 1
2008_002132 2
2008_002132 3
2008_002132 4
2008_002132 5
2008_002132 6
2008_002132 7
2008_002132 8
2008_002169 1
2008_002176 1
2008_002259 1
2008_002259 2
2008_002456 1
2008_002470 2
2008_002470 3
2008_002470 4
2008_002470 5
2008_002470 6
2008_002576 1
2008_002639 1
2008_002677 1
2008_002677 2
2008_002725 1
2008_002725 2
2008_002725 4
2008_002725 5
2008_002725 6
2008_002756 1
2008_002756 2
2008_002809 3
2008_002829 1
2008_002843 1
2008_002908 1
2008_002910 1
2008_003220 1
2008_003424 1
2008_003424 3
2008_003483 1
2008_003531 1
2008_003546 1
2008_003546 2
2008_003546 3
2008_003593 1
2008_003610 2
2008_003610 3
2008_003610 4
2008_003671 1
2008_003721 1
2008_003721 2
2008_003754 1
2008_003766 1
2008_003874 1
2008_003874 2
2008_003884 1
2008_003933 1
2008_004018 1
2008_004076 1
2008_004135 1
2008_004137 1
2008_004137 2
2008_004137 3
2008_004203 1
2008_004203 3
2008_004221 1
2008_004221 3
2008_004221 5
2008_004263 4
2008_004455 1
2008_004455 2
2008_004455 3
2008_004534 1
2008_004534 2
2008_004875 2
2008_005098 1
2008_005490 1
2008_005588 1
2008_005701 4
2008_007112 1
2008_007112 2
2008_008335 1
